############################
#p  i   1b* *    *   *  * *#
# # # #*# # #*#*# # # #*#*##
#   *      ***  *      *   #
# # # # # #*o # #*#*# # # ##
#f         x **1 *  *  2   #
# # # # # # # # # #*#1#*# ##
#*  *      *  *      *     #
# o # # #*# # # #*#*# o # ##
#*    **  *       *        #
# #*# # # # # # #*# # # # ##
#           *1  *  *       #
############################

